=######===
## X #####
# T #X   #
# X #  O #
#   #O   #
#   C  S #
# B  T C #
#    O T #
# TC E   #
##########