=######===
## X #####
# T #X   #
# X ## O #
#    #   #
#   C  SC#
# B  T   #
#    O T #
# TC E   #
##########