=######===
## X #####
# T #X   #
# X #  O #
#   #O   #
#   C  S #
# B    C #
#    O   #
# TC E   #
##########