=####===== 
#XXX#==##=
#O  ###T#=
#% ##M#P#=
#   #S# #=
#T    #%##
# CC C   #
##   EC  #
===#    ##
===######=